############
#....#.....#
#.##.#.###.#
#....#.....#
#.######.#.#
#........#.#
#.####.#.#.#
#......#...#
#.##.###.#.#
#..........#
############
